#####
#   #
# * #
#   #
# @ #
#   #
#####
