#####
#.  #
# $ #
#  @#
#####
