<><><><><><><><>
<><><> _ _<><><>
<><><>    B P <>
<><><>B       <>
<><><>    <><><>
<><><><><><><><>
