############
#      #   #
#      #   #
#      $.  #
#.$ ####@  #
#   #      #
#          #
############
