####################
#  #      #   #   ##
#  #     ##   r    #
#     # ##    #    #
# ##   ##    #     #
#      #    ##     #
#  ##  #   #       #
#      ## ##  ### ##
# # #  #   #  #    #
#   #     ##  $$$  #
#    #    #@       #
####################
