####################
#..#    #         $#
#.$  $  #$$  $##  ##
#.$#  ###  ## ##   #
#  # $ #  $$   $   #
# ###  # #  #$  ####
#  ## # $   #@ #   #
# $    $  ##.##  $ #
#  # $# $# $     ###
#  #  #  #   ###   #
#  ######## #      #
#           #  #.#.#
##$########$#   ...#
#    .*  #    ##.#.#
# .*...*   $  .....#
####################
