         #####
     #####   #
    ##       ####
#####        ## #
#           ##  #
#  ###### ###   #
## #  #    #    #
#  $  #    #    #
#@ #$ ## ####   #
####  $     ##  #
   ##  $    r   #
    # $$$   #   #
    #   $    ####
    ######   #
         #####
