#########
#  #  . #
# $@$   #
#    #. #
#########
