<><><><><><><><><><><><><><>
<> _ _    <>          <><><>
<> _ _    <>  B     B     <>
<> _ _    <>B <><><><>    <>
<> _ _        P   <><>    <>
<> _ _    <>  <>    B   <><>
<><><><><><>  <><>B   B   <>
<><><>  B     B   B   B   <>
<><><>        <>          <>
<><><><><><><><><><><><><><>
