    #####
    #   #
    #$  #
  ###  $##
  #  $ $ #
### # ## #   ######
#   # ## #####    #
# $  $           r#
##### ### #@##    #
    #     #########
    #######
