        <><><><><>
        <>      <>
        <>B     <>
    <><><>    B <><>
    <>    B   B   <>
<><><>  <>  <><>  <>      <><><><><><>
<>      <>  <><>  <><><><><>     _ _<>
<>  B     B                      _ _<>
<><><><><>  <><><>  <>P <><>     _ _<>
        <>          <><><><><><><><><>
        <><><><><><><>                
