<><><><><><><><><><>
<> R<><><><><><><><>
<>                <>
<>    <><><><>B   <>
<><><><><><><>    <>
<><><><><><><>P <><>
<><><><><><><><><><>
