############
#    #     ###
#    # $  $  #
#    #$####  #
#    r @ ##  #
#    # #  $ ##
###### ##$ $ #
  # $  $ $ $ #
  #    #     #
  ############
