           ########
           #      #
############      #
#    #  $ $r      #
# $$$#$  $ #      #
#  $     $ #      #
# $$ #$ $ $########
#  $ #     #
## #########
#    #    ##
#     $   ##
#  $$#$$  @#
#    #    ##
###########
