        ########
        #     @#
        # $#$ ##
        # $  $#
        ##$ $ #
######### $ # ###
#      ## $  $  #
##     r $  $   #
#      ##########
########
