###########
###.#######
###.#######
###.#######
###.#######
###.#######
###+#######
###  $    #
##  # ##  #
#  ##  # ##
# $  $  $ #
#  #  ##  #
## ## ## ##
# $# $   ##
#     #  ##
#  #  #####
###########
