        #####
##### ###   #
#   ###     #
# * * # * +##
##     $* ##
 #  *## * #
 ##  ##  ##
  ########
