  #######
 ##  #  #
 #      #
## # #  #
#  *** ##
#@#*  $#
#  *** #
### .  #
  ###  #
    ####
