  ####
 ##  ##
 #@ $ #
## .* ###
# $$*.* #
# #.. # #
#   $   #
###  ####
  ####
