 ######
 #    #
## * .##
# *$*  ##
#@ * *  #
##* *   #
 #   ####
 #####
