 ########
 #   #  #
##.     #
# ***** #
#   * * #
## #$  ##
 #  @###
 #####
