  ####
  #  ####
  #    @##
 ##** ** #
##  **.  #
# $  # ###
#      #
########
