   #####
 ###   ##
##   #  ##
#  * * * #
#+  $ *  #
#### * ###
   #  ##
   ####
