  ####
 ##  ###
##  .  #
# $.$.$##
# .$.$. #
##$ #.$ #
 #  @  ##
 #######
