   #####
####   ##
#  * *  #
#  . *  #
##$.$*$##
 # . *@#
 #   ###
 #####
