    ####
   ##  #
 ###   ####
## * * *  #
#  * * $  #
#  * # * ##
## . ##@ #
 #  ######
 ####
