#############
#@$ $ $ *...#
#  $ $ $.*..#
# $ $ $ *...#
#  $ $ $.*..#
# $ $ $ *...#
#  $ $ $.*..#
# $ $ $ *...#
#  $ $ $.*..#
# $ $ $ *...#
#  $ $ $.*..#
#############
