     #####    #####
######   ######...##
#   ## $ #  ##.... #
# $$   $ #   #.. . #
#   ### ## $ #....##
### #     $  #....#
 ## #   ### #####$#
 ## ###   # ##    #
 # $  @$$ # ##$$$ #
 # $ ##   # ## $  #
 #   ##### $## # ##
 #####  #     $ $ #
        #   #     #
        ###########
