  ####      ######
  #  #      #    ##
  #  ###   ##     #
  #$   #   #   #  #
  # $# #####      #
  #   $   # # #####
###$$   # # # # #
# $   $   # #   #
# @$ $ ###  # # ##
#  ## #          #
####...#  #    # #
   #..*.# # # $  #
   ##..*.# # #$ ##
    ##..* $    $ #
     ##..    #   #
      ############
