###################
#  #   #   #   #  #
#  $   $  $    $  #
# $########## ##$ #
## ## *.*..*.* # ##
#  ## ..*..... # ##
#  ### ######### ##
#  #      $ #   $ #
## #   $#$#@  #   #
## # #       ######
# $  #########
#   ##
#####
