      ####
#######  #
#  #     #
# $$ $#  #
#  ##.# ####
## ##.#  $ #
## # . $ # #
#   *..#   #
#  # . # ###
## ##.##$#
 #     $@#
 #  ######
 ####
