 ##########
##  ..... #
#  #..... #
# $ #### ##
# $  @   #
## $ $ $ #
 # $$$$$ #
 #   #   #
 #########
