##############
#     #      #
# $$$    $$$ #
##   $$$$   ##
 #$ $    $ $#
 #   $$$$   #
 #$$$    $$$#
 # $ $$$$ $ #
 #          #
######..######
#..*.****.*..#
#..*......*..#
##.********.##
 #..........#
 ######@#####
      ###
