     #####
######   #
# $ .. $ #
#@$$.. $##
# $ ..  #
#########
