  #####
  #   ##
### *$ #
#  .$. #
#  $. ##
###  @#
  #####
