      ####
#######@ #
#   #    #
#   $  $ #
## ##$# ##
 #  $ #*.#
 ##  $...#
  #   #. #
  ########
