 ########
 # @    #
##  ..$ #
#  #..###
# $$$##
#    #
######
