 ###  ####
##.####  ##
#...  #  @###
##..     $  #
#...  # $ $ #
##.###### ######
 ###    # $ $  #
       ## $ $# #
       #   $   #
       #  $ $# #
       # # # # #
       #       #
       #########
