#######
#  #@ #
# $$$ #
#  $  #
# $$$ #
#..#..#
#..$..#
#######
