 ########
 #  #  @#
 #$  $  #
 # ## $ #
##...$ ##
# ...# #
# #$$  #
#      #
########
