 #######
 #     ##
 # $  $ #
 ## # #@#
  #.# $ #
###..$ ##
#  ..# #
# #.*# ###
#  #.$$$ #
##   # # #
 ###     #
   #######
