  ####
  #  ####   ####
  #     #####  #
  #  $$$       #
  ## #  #  # # #
   #$ $ ####$# #
   # $####     #
####  #  #  ## ####
# @$$    ## # ....#
# #  $$ ### # ....#
# $ $  $    # ....#
# ## $  ##  # ....#
#    $  ###########
######  #
     ####
