  ############
  #    #     #
  # $  $ $ $ #
###### ##$ $ #
#..  # #  $ ##
#..    @ ##  #
#..  #$####  #
#..  # $  $  #
#..  #     ###
############
