   #########
   #  ##   #
   # $  $  #
   #  $# $ #
#### $ #$  #
#..### # $ #
#..  # # $ #
#..     $$ #
#..  ###   #
#..  # ##@##
######  ###
