####      ####
#..########..#
#.*.*.....*.*#
#$ $ $ $ $ $ #
# $ $ $ $ $ $#
#$ $ $@$ $ $ #
# $ $ $ $ $ $#
#*.*.....*.*.#
#..########..#
####      ####
