   ####
   #  #####
 ###$ $   ###
 #  $ #  $  #
 #    ## ## ##
 #  ###  ##  #
 # #  $ $ ## #
 #$  $ $ $#  #
## ###  $    #
#     #$ ##$ #
# ....#  #  ##
##....# # @##
 #.#.#  $ ##
 #....   ##
 #########
