    ######
    #....####
    #....#  #
    #...  $ #
#####   #   #
#   #####$####
#   #      # #
## $  $#     #
 #$ ## # $ $ #
 #  $   ####$##
 # # #  ####  #
## $       $  #
#@  ########  #
#####      ####
