######
#    ######  ####
# $  $ #  ####  ##
#  $   # $$      #
##   $$#  ### #  #
 # $#  ## ##  #  #
 #$ $  $@$ # ##  ##
 #  #  #   # #....#
 # $ $ ##$## #....#
 ##   # #  # #....#
  ##### #  $ #....#
        #  # ######
        ######
