      ####
      #  #
      #$ ###
      #   ###
 ######$ $  #
 #... # $   #
 #....  $$ ##
 #....#   $#
 #....#$ $ #
#### ##   $#
#@$ $ # $  #
## $  ## ###
 ##     $#
  #####  #
      ####
