    #########
    #.......#
    #.......#
    #.......#
    #### $###
     #  $  ##
     # $ $  #
 ###### # # ###
 #  ## $ $ $  #
## $$         #
#   #####$##$##
#   $     $ $ ###
######## $#     #
     #  $ #  #  #
     #   @#$  $ #
     ## $ $   $ #
      ########  #
             ####
