######
#....#
#....#
##   ############
 #   #  #   #   #
 ## ## $ $ $$   #
  #    @# # #####
  #  ##$# $  #
  ####   $   #
  #  $   #####
  #      #
  ########
