       #######
########.....#
# $   $ .....####
#  $ $ #.....   #
##  ## #.....#  #
 #  $  ###$### ##
 # $  $  $   $ #
 #$####  $   $ #
 #   #  $# #####
 ###   $$ $ $  #
   #### $  $   #
     #@  #######
     #####
