   #####
   #...#
   #...##
   #....####
 ####......####
 #  #....     #
##  ###  ###$ #
# $ $ #$#  #  #
# $    $  $## ####
#  #  # #   $$$  #
##  $## #$ $     #
 #$  $  # $ $#  ##
 #  $# $ $   ####
 ##  ## @#   #
  #  #########
  ####
