   #####
   #   ##
   # #  #
 ### $  #
##   # ##
# .#.#  #
# ..*$$ #
# *#.#  #
##  ##$##
 #$ @  #
 #  ####
 ####
