      ########
      #      ##
 ######  ##$$@#
##  #  $$ #   #
##$       $ $ #
#   # $########
#  $#  #... .#
# $ #$$ ...  #
#  $#  #...  #
##  #  #...###
 #  #  #####
 #######
