            #####
     ########   #
######@#   ## # #
#   ##   $      #
#...   ## ### ###
#..## ##    # #
#..#  ##$#### ##
#..# $$     #  #
#..#  ## $  $  #
#####  #  $ #  #
    #$$ $$# ####
    #       #
    #########
