########
#      ######
# ####      #
# #  ### ## #
#     $   # #
# #  #    # #
# #$ ### #  # ######
# # #### # #### ...#
# #   # $$ #  #  ..#
# #   #   ##$    ..#
#  $$ #     $ #  ..#
###   #   ##$ ######
  ##########@ #
           ####
