#####
#@  #######
# #$#  #  #
# $    $$ #
### ##$#  #
 #  # .# ##
 #  $..   #
 #  #..## #
 #####.   #
     ######
