      #####
     ##   #####
 ##### $  #...#
 #   # # ##...#
 # #   # #.. .#
 #   ##   ....#
####  $$$ $#  #
#  # ##  $ ####
#  # ## $  #
# $$$ $  $$#
## #@##    #
## #### #  #
#       ####
#       #
#########
