            ########
        #####   #  #
      ###   #$ $ $ #
     ## #     $ $  #
 #####    # #$ # $ #
 #  #  # ## #   #  #
 #    ##### ### #$ #
 # $## ...# ##  $  #
 ## ## ...#  #    ##
 #  ###...   ######
 #  $ ....####
 #  #######
### $ #
#@$   #
##  ###
 ####
