   ######
 ###    ###
 #        ####
 # #$$$## #  #
 # #    # #  #######
 # #    # # $   ...#
 # #$#$## #$    ...#
##         $$###...#
#  #$$$## #$   #...#
# #     # #    #...#
# #  $  # # ## #...#
#  #$#$##  #   #...#
##       $   $ #...#
 # #$$$# ####$##.###
 # # @ #  #  $   #
 #  ###   # $$ ###
 ##     ###    #
  ####### ######
