####
# @#
# $#####
#  $   ##    #####
#   $#  #    #   #
##   $  #    # $ #
 ##$# $ #######  #
  #   #$    #  ..#
  # # # $## # #..#
  #      $     ..#
  ###########  ..#
      #     #$#..#
      # $      ..#
      #     #   ##
      ###########
