      #####
  #####   #######
  #@$    $   $  #
 #### #$#  ##$  #
 #  #  $  $ #   #
 #  ### ##  # ####
 #  $ # $  #  $  #
 #        ### $  #
#######$ ##  $ ###
#.....#  #  $  #
#.....## $ #$  #
#....     $   ##
#...   ########
########
