#######
#     #
# ### ###
# #  $  #
# # $ $ ##
# #@ #$  #######
# # $# $$#  ...#
# #$ #   #  ...#
# #  #$     ...#
# #$ #  $#  ...#
#   $ $  #  ...#
###  $  $#######
  ### ## #
    #    #
    ######
