    ###########
 ####.........#
 #   .*******.#
 # ###.......##
## # #.$$$$$.#
#@ ####     ##
# $  ## $$$ #
# $ $  #   ##
# $ $ $    #
# $ $ $  ###
# $ $  ###
# $  ###
#  ###
####
