 ###
##@#########
# $#   ##  #
#      $   #
# $##$###  ##
#  ## ### ###
#####.###   #
    #....#  #
    #....#  #
    #....## ##
   ### ####  #
   #         #
   #   #### ####
   #####  $ $  #
       # $ $   #
       # $$$$$ #
       #       #
       #########
