####  ####
#  ####  #
#   @    #
# $$$$$$ #
##      ##
# $$$$$$ #
#        #
#  $$$$  #
###    ###
 # $$$$ #
 #      #
 #  $$  #
 ###..###
 #..**..#
 #......#
 #..##..#
 #......#
 ########
