  ###########
  #....   ..#
  # .......##
### .#....#####
#  #$##..##   #
#     #### $  #
# $$  #  #  $ #
##  $$#   $$ ##
 #$  $   #$  #
 # $$ #  #  $#
 # $ $#### $ #
 #       #  ##
 #### $  # ##
    ### ## #
     # $   #
     #@ #  #
     #######
