   ######
   #    #
#### ## #######
# @$  $   #   ##
# # $  $  # $  #
#  $  ##### #  #
#### ##  #### ##
  #  #  ##  #  #
  #            #
  #######  #  ##
   #..  #  ####
   #..      #
   #..  #   #
   ##########
