#######
#.....#
#...#.#
#.. ..# ####
#.    ###  ########
#### ## $         #
####    #  $$ #   #
 #   $ #  # $ #####
 # # $ $$ # ###
 #  #$##     #
 ##  $ $$## ##
  ##   @  $  #
   ###  ###$ #
     #### #  #
          ####
