       #########
       #  ##   #
     ### $     #
  #### @$  ##$##
###  #### ### #
#  $ # #.*..# #
# #   $ ....# #
#    # #....$ #
###  # #####  #
  ####    $   #
     ###$  $ ##
       # $$ ##
       #   ##
       #  ##
       ####
