##################
#   ##       $...#
# $ $ $#$ ####  .#
# $$#$       @...#
# $   #$##$$ #...#
# $ $$#    $ #...#
#         ## #...#
##################
