 #######
 #     #
 # $ $ #
 # $ ####
## $##  #########
#   #  $  ......#
# *##  #$ #  $  #
#.....*.  ## $  #
#.###   ##  ##$ #
### ######      #
      #@$  $ $$ #
      ###   #   #
        #########
