              ####
             ##  ###
##############  $  #
#........... #   $ #
#.# #######. #$ $###
#.# ####### ##   ##
#..           $$$@#
#  ######## ##    #
####   #   $$ #####
       # $    $ #
       ## $$  $ #
        ##  $$  #
         ##     #
          ##   ##
           #####
