        #######
        #     #
    #####     ###
#####   ## ##...#
#     # ## ##...#
# ###$$$ $ ##...#
# #   $ $  ##...#
# # #$ $ $###...#
# #   $@$   ## ##
# #  $ $ $ $#  #
# # ######     #
#              #
################
