             ####
      ########  #
      #     #   #
    ### ###   # #
#####     $   # #
#   $ $ ###$$ # #
#  $ $$$  # $## #
#  #$   #  $  # #
##   #### ### #$##
 # ###......     #
 #   $......## # #
 # ###......##   #
 #$$ #   #########
 #     # $@$ #
 #######     #
       #######
