    ####     ####
  ###  #######  ##
  #  ........... #
  # $ ##### ### $##
 ####  $ $ #   $  #
 #  #  # # #$# @# ##
 #         #   $ $ #
 #   ##   # $$$#   #
##  #     #      ###
#    # ##  #  ####
#         #   #
########  #####
       ####
