  #####
  #   #
###$# ###
# $...  ###
# #.#*#   #
# $.#.$   #
#  ## ## ##
## @ $ $ #
 ###   ###
   #####
