          #### ####
          #  ###  #
          #  $    #
          # # $ $ #
      ##### # #  ##
      #.....# $$$#
      #....* $   #
      #*..*.# #$##
#######....*# $  #
#     $*.*..#    #
#  $$ # ##$###$$ #
#    $   #      ##
#####$ $ ####  ##
 #@# $        ##
 #    ######  #
 ######    ####
