      #####
     ##   ##
    ##  *  ##
   ##  * *  ##
  ##  * * *  ##
 ##  * * * *  ####
##  * * * * *  # ##
#  * * * * * *    #
# * * * . * * *@$ #
#  * * * * * *    #
##  * * * * *  # ##
 ##  * * * *  ####
  ##  * * *  ##
   ##  * *  ##
    ##  *  ##
     ##   ##
      #####
