  ########
 ##..    #
 #...$ $ #
###.## ###
#   ##$ #
#  $@$  #
##$ ##  #
 #  #####
 ####
