  ####
  #  #
  #  #########
  # $$ #.....#
  #    #.*...#
 ###   $..##.#
 #  #$##$  #.#
 # $  ## ## .#
 #  ##  $ $ ##
###@ #$    ##
#  $$ $   $#
# $  ####  #
#    #  ####
#   ##
#####
