###
# ##    ####
#  ######  ###
#   # $ $$ $ ###
#  $ @ $    $  #
# $ # #$  $    #
#  ## # ### ####
# ##    #  $  #
###... ## $ $ #
##....##   $  #
#....## $  $###
#...###  $  #
#...# #  ####
##### ####
