    #####
#####   #
#.. $ $ ##
#..$ $  @#
##. $## ##
 ###    #
   ######
