           ####
      ######  #
      #   $   #
      # $$ $  #
      ## # $  #
 ######   $ # #
 #      $ $ $ ##
 # ## #######  #
 # $  ##...##$ #
##   ##...#.#  #
# $ $ #.....$$ #
#    $$.....#  #
##$   #..#..#$##
 # $#$####### #
 #    #       #
 #### # # #####
    #   #@#
    #######
