    ######
    #    #
 #### ##$###
 #         #
 # #....#  #
## #....#$$#
#   ....#  #
# ##....   ##
# ##....#$$ #
#  $....#   #
# $#### #   #
#  $  $$$$$##
##$    $   #
 # $$# #   #
 #  $ $ $$$#
 # $   $   #
 #@##   ####
 ########
