 ####
 #  #######
 #$  $    #
 #   # #$ #
 # #. .# ##
 # $...  #
##$#...# #
#   $## $#
#     $  #
####### @#
      ####
