 #####
 #   #    ##########
 #$  ######    ##  #
## $$  $   $  $... #
# $ ##   #  #$#.#. #
#    ##  ##$ $ ... #
# $#    $ # # #.#. #
#  ## #$  #    ... #
# #  $#@$## # #.#. #
#  $$ #$ #  #  ... #
###      #  #   ####
  ###   ##  #####
    #########
