   #####
   #   #
   # #$#
####   #
#  #.# ##
#  *.* @#
#  #.#  #
## # #$##
#  # #  #
#    $  #
#  ###  #
#### ####
