     #####
######   #
#  #     #
# $$  #  #
#   ### #######
##  #.....#   #
 #  $...*. $# ###
 # $#.....# #   #
 ## ####$##     #
 #  #      $ ####
 #  # @ $ # $#
 #  $  ##$   #
 ### #$   ####
   #  $ $ #
   ##  #  #
    ####  #
       ####
