   ####
   #  #####
 ###$     #
 #     .# #
 # ## #.  #
 # $  #*####
## ####.   #
#  #  @.#  #
# $  #$.#$##
###    . $ #
  ######   #
       #####
