          #########
          #       #
          # ### # #
     #### # #...# #
######  ###  ...  #
#         # #...# #
#  $#  $  # ## ## #
##  #### ##$      #
 # ##### #  #$ ####
 # #### $    $ #
 # $ ##$ ###   #
 #      $@######
 # # ######
 #   #
 #####
