####
# @#   ####
#  #####..###
#  # $  $...#
##   #  ... #
 #$$  ###$# #
##  # ### $ #
# $   $   # #
#    ####   #
######  #####
