     #####
######   #
#   ## # #
#        #
##$###*###
## #.@.##
#  *.#  #
# # $ $ #
#   ##  #
#########
