     #####
  ####   #
  #    #@#
  # ###  #
  # #  $ ###
  # # # $$ #
  # # $$   #
### #   #$ #
#   # $$ $ #
# $ $      #
##$#########
# ....#
# ....#
# ....#
#######
