#########     #####
#       #######   #
# # # # #         #
#   $ $ # ###### ##
#####$#$# #  ..  ###
  #  @$  $   ..# $ #
  # #$#$# ###... $ #
  #       ##...#   #
  ##################
