 ####
 #  #
 #  ###
 # $  ###
## ##.  #
# $$..# #
#  #*.$ #
## #. ###
 #   @#
 #$ ###
 #  #
 ####
