       #####
####  ##   #######
#  #  #  $   $   #
#  #### $ $ $ #  #
#... $ $  #$#$## #
#...# $ $        #
#..# $ $ $########
#...$ $ $@##
###### $ $ ###
     # ##  ..#
     # #  ...#
     #    ...#
     #########
