    #####
    #   #
##### # #
#   $   #
#   #$#####
##$## $ $ #
 # ...#   #
 # #..*   #
 # @ ######
 #####
