 ###### ######
 #    # #    #
## ## ### $  #
# $$     $$  #
#  $ ## ## # #
# # $ $    # #
# $  $  # ## #######
#  # #$   ## ##    #
#### #  #### ## ## #
 #  $ $##  #       #
 # $ $     # ## ####
## ## ###  #   ....#
#   # ###   ## ....#
#   $$#       .....#
#   #    #@####....#
############  ######
