  #########
  #.......#
  #.......###
  #         #
  ##  ##### #
   # ##   # #
   # #   $  #
   #  $ $ ###
  ##$#   $ @#
  #  ## # $##
###$  $$#  ###
#       #$   #
# # $ $ $  $ #
# ###### #  ##
#        ####
##########
