#########
#....   #
#....   #
#.#... ##
#....#  ########
######$$   #   #
   #    ## $$# #
   #  #  ##  $ #
   ## $ $   ## #
   #   # $   # #
   #   $ #$  # #
   ## ## # $ # ##
    #$ #$#  ## @#
    #  # #$$ $  #
    #          ##
    ############
