#### #####
#  ### @ ###
#..     $  #
#..# # $ $ #
#..#  ## ######
#..   ## $ $  #
#..#  ## $ $# #
#######   $   #
      #  $ $# #
      # # # # #
      #       #
      #########
