###########
#  #   #  #
#  $  $   #
#  ##.##  #
## ...##$##
##$#...   #
#  #.##$# #
# $$  $   #
# @#  #####
#######
