##### ####
#   ###  ######
# $  $ @$.... #
##$ $  #$.##. #
 #  # $# ....##
 #  $  #$.##. #
 # $  #  .... #
 #$$$ # $$  $##
 #    #  ##  #
 #############
