   #####
   #...######
   #...#    #
   #...$ $$ #
#####.. @# ##
#    $ ### ###
#   #$####   #
## $     ### #
 #   # $  $  #
 ######  # $ #
     #  $#$# #
     #       #
     #########
