    #####
    #   #
 ####$# ###
 # $  @$  ###
 #   #    $ #
###$## $$   #
#....#$#  $ ##
#..... ###$  #
##.#.  #   $ #
 #... $#$ #  #
 #  #   $ ####
 ####  ####
    ####
