###########
#   ##..  #
# $ ....# ##
#  #.... @ ###
#  #.#.. #   #
####.###  $# #
 ##  ##  $ # ##
##   #  #$    #
#  $ #$$#   # #
# # $  $ ##   #
# ###$ $  $  ##
# $    ##    #
# $   ####   #
#  ####  #####
####
