 #######
 #...  #####
 #...#$#   ###
 #... $@ $   ###
 ##$$# ##$#$   #
 #   #     $$# #
 # $###$## # $ #
 # $.#.$       #
##  ...#$$ #####
#  $#..  ###
#   ##.   #
#######   #
      #####
