 ####   #####
 #  #####   #
##*   * #$# #
#   #   #   #
# * . *  ** #
######   #@##
# .   ###   #
# $ *    *# #
##*   * **  #
 #  ####    #
 ####  ######
