      ####
      #  #
    ###  ####
#####       ###
#   $ #$###   #
#  $@$....#$$ #
######..*.  $ #
   #####..#####
   # $ $ ##
   #     #
   #######
