         #####
         #   #
########## * ###
#          .   #
# $$$$****$...@#
#          .   #
########## * ###
         #   #
         #####
