########
#  .$  #
# .$.$ ##
#*$.$.@ #
# .$.$  #
#  .$ ###
#######
