#########
#  .#   #
#  $ $*.#
# $## # #
#   #   #
# * #  ##
##  .@##
 ######
