###########
#    .    #
#  $.$.$  #
###.$.$.###
  ##.$.##
   #$.$#
   # $ #
   # @ #
   #####
