       #####
########   #
#......... #
#  $ #$#   #
# $#    # ###
#  #  # $   #
#$### $ # # #
#@$    $  $ #
######  #####
     ####
