          #####
          #   #
########### # #
#             #
# # $#######$$#
# #  *.....#  #
# #$ #.***.*  #
# #  #.....#  #
# #  ####*###$##
# #         $  #
# $ $ $ $ $ $ @#
##  ############
 ####
