###########
#  .$ $.  #
#  .$  #  #
#.#*#..*..#
#$ .$$$#$$#
#  .$@$.  #
#$$#$$$. $#
#..*..#*#.#
#  #  $.  #
# $. $ .  #
###########
