   #####
   # @ #
   #$$$#
#### . ####
#   *.* $ #
# $.....$ #
# $ *.*   #
#### . ####
   # $$#
   #   #
   #####
