#######
# $. @#
#  .$ #
# **$ #
#* .$*#
# $*. #
#  .$ #
#  .  #
#######
