#######
#  *  #
# $.$ #
#  .$ #
#.*.*.#
#$ *  #
# $. $#
#@ *  #
#######
