   ######
####    ####
#@ $.#*$   #
# $ ...# $ #
###$#.     #
  #   ######
  #####
