#############
#.          #
#.#$#$#$#$#$#
#.          #
#.#########.#
#.#.  $ ..$$#
#.# $ $ *.$@#
#.#.* $ ..$*##
#.#########  #
#.$ $ $ $ $  #
#.           #
##############
