 ########
 #......#
 #......#
 #......#
 #      #
 #      #
 #### ##########
##  $    $ $ $ #
#    $ #$#   # #
#@#$ $ $  ##   #
### $# #  #### #
  #  $ $  #    #
  # $# $ #  $  #
  #    $   $ $ #
  #  ###########
  ####
