#####
#...##########
#....$ $     #
#..*. $   #  #
#.*..### ## ####
#....# $  #    #
###### #$ #$#$ #
  #@$  $  # $  #
  ##      #    #
   ########$ # #
   #     $   $ #
   # # # # $## #
   #   $   $ $ #
   ########    #
          ######
