    ######
  ###    ####
  # $ $ $   ##
###    $ ##  #
# $ # ##$  $ #
#   #$   $   #
#  $   $  $$ #
# $@## ### ###
#   #  #. ...#
#####   .....#
    ####.....#
       #######
