     ######
######    #####
#   #  #  #   ##
# $$  $#$#  $  #
#  #.#...  $ $ #
#   .....@# $  #
# $#.##*#  $$$ #
##  ....#$ #   #
 ###.#...  #####
  # $ $#$# #
  # $#   $ #
  #    #   #
  ##########
