########
#  #.#.##
# $.$. .#
#   .#$##
####   #
   #$$$#
   # @ #
   #####
