  ##########
  #        #
 ## $ ##   #
 #@ $$$  # #
 ##  $ $$  #
######  $$ #
#... #$ $  #
#..  # $## #
#..     #  #
#..  # ##  #
#... #     #
############
