  #######
  #. .  #
####$#$ #
# $. .  #
#@$# #$ #
# $.$.  #
####.  ##
   #####
