######
# # .#
# $ .#
#@ $.#
# $$.#
#  ###
####
