####
#  ###  #####
# $$ #  #...#
#    ####...#
# $ $ $  ...#
# $  #### ..#
### ##  ##$###
### ######   #
#  $  #    $ #
#    $  # $  #
##@#  ###   ##
 ###### #####
