##############
#....#       #
#*...# $ $ $ #
#..####  $   #
#..#  #   $$ #
#..$  ## #   #
# $#  $  #####
#  #  #      #
## #### ## # #
# $    $ #   #
# #$#$#@ #####
#       ##
#########
