  ###########
  #.........#
  #.........##
##########$$ #
#     $  $ $ #
# @##$ $  $  #
# $#  ## ### ##
#    $$ $   $ #
####$  $  #$$ #
   #  $#      #
   #     ######
   #######
