#########
#....   #
#....$# #
#.#..  $##
#..@ #$  #
###### #$#####
  ##   $   $ #
  # $$ #$    #
  #   $   $$ #
  #   #$   ###
  ###    ###
    ######
