###############
#             #
# # $..... ## #
# ##.$###$. # #
#    . # .  $ #
# $#@$...# #  #
# $  . # .$ # #
# # # ... #   #
#   ##$#$##$$ #
# #  $ #      #
# $ #$ # $##$ #
#      #      #
###############
