####
#  #####
# $$ $ #######
#        ##  ###
### ####$# $ $ #
#....        $ #
#....####$ #   #
#....###  ## $ #
##.#### $ $@$# #
 #    $   #    #
 #  #    #######
 #########
