          ####
###########  #
#      $   $ #
#  ##### ### #
## # $...$ # ##
 # # $...     #
 # #@#...###$ #
## ## ...    ##
#  $ $$$ #####
# $$   ###
#      #
########
