       ####
      ##  #
 ###### $ #
##    # $ #
# $ $   # ####
#  ##$#....#@##
# #   #....   #
# # $$ ....## #
#     #....#  #
### # ### # $ #
 # $  $ #$ $  #
 #   $  # $  ##
 # $# # ##  ##
 # $  # #  ##
 #  ###   ##
 #### #####
