          #####
        ###   #
    #####   $ #
#####   # $#$##
#....$ $#     #
#....$#   $ $ #
#....@#  ###$##
#....#   $    #
## #$ $ $ #   #
# $$ #$########
#      #
###   ##
  #####
