        ####
     ####  ##
 ##### $    #
 #   #   #$ ##
 # $$ #$#....#
##  $    ....#
#  ## $ #.##.#
# #  ## #....#
#  $ @ $  $ ##
## $ $ #$ #$#
 #   ###    #
 ##### ######
