  #####
 ##   #
 # $# ####
##  .....##
# $ #.....#
# #$ # ...##
#   $# ##  ##
#    $$###$ ##
# ##$#  @  $ #
#    #$$ #   #
### # $  $ ###
  #   #  ###
  ########
