     ####
 #####  ##
##    $  ####
#  $  #$  $ ##
# $ #   #    #
#  ### $@ #$ #
######...##  #
   ####..#####
 ###  ... #
## $$#... #
#  # $ ## #
# #    $  #
#     #####
##   ##
 #####
