  #########
  #      @#
  #$ $ $  #
  # ##$# ##
 ##.. .. #
 # .. ..##
## #$## #
#  $ $ $#
#       #
#########
