######
#    ######
# $$$#    #
# @$ # ## #
# $$....# #####
#  #.#.*# #   #
#  #.#*.$     #
#  #.*.. ###$##
#######$#  #  #
      # $$    #
      #    #  #
      #  ######
      ####
