        #######
        #     #
        #$$ $ #
   ######  $  #
   #   ## $ $ #
   # ....*  $ #
   # .###.#####
   ##.# #.#
#####.###.#
# $  *....#
# $ $ #####
#@ $  #
# $ $$#
#     #
#######
