#########
#   @   #
#$$$$$$$#
#...#...#
#.......#
#$$$ $$$#
#       #
#########
