 ########
 #  @   #
##$ $ $ #
# $ # $ #
#  $ # ##
#......#
########
