   ####
   #  ###
####  $ ####
#    $# #  #
# $#  #   @##
#    #  #  ####
# #$ $ #..... #
# $ # $ ..##. #
##$  # #...*.##
 #  $#  #..#. #
 # $  #$$  $$ #
 #  # $    #  #
 ####    ######
    ######
