    ########
    #  ....#
 #### #....#
##  # $...##
#  $ #$.*. ###
#    $ $# $$ #
# $#  @ #    #
##  #  #  $ ##
 #  $ # $ ###
 #  #  $ $#
 #####    #
     ######
