##############
#   ###      #
# $$$     $$ #
# $ ### $ $  #
# $ #  ### ###
#   #.*...$@##
#   #.....#$ #
## # ...#.#  #
## # .....#  #
##$#####  # ##
#     $ ###  #
# $$ $    $$ #
#       ###  #
##############
