   #####
####   #
#  $.# ##
#   $   #
#.##.##.#
#  $$$  #
####.  @#
   ######
