 ##########
 #    .   #
## $##$## #
# @$. . .$##
#   ##$##  #
###   .    #
  ##########
