########
#   @  #
# #$## #
# $  $ #
###  $##
 #. $.#
 #. ..#
 ######
