#######
#  .  ####
# $.$ $ @#
#  .####.##
#  $ $ $. #
####    . #
   ########
