##########
#    $  .#
#  $##$# #
#   $    #
### ## ###
#  $#  ##
#.*.  $@#
#...##  #
#########
