 #####
 #   ######
 # $.##   #
 ##$...$  #
### .$. ###
#@$ $$###
# $ ..###
# $  .  #
#####   #
   ######
