  #########
 ##.......##
## .$$$$$. ##
#   #   #   #
#  #*#@#*#  #
##  #   #  ##
 #. $$$$$  #
  #.$     #
   ##   ##
     ###
      #
      #
