  ####
###  ######
#    ##   #
# #     $ #
# $$ #$#$##
### $    ###
  ##  ##.*.##
   ##$ $... ##
  ##  ##...  #
  #   $ #. @ #
  # #   $.# ##
  #    ##   #
  #######  ##
        ####
