 #######
##  *  ##
# . .@. #
#   * $ #
#*$$*$$*#
# $ *   #
# . . . #
##  *  ##
 #######
