#######
#     #
# $.$ #
# .$. #
#*$.$*#
# .$. #
#  .$ #
# @   #
#######
