 ######
 # @  ##
 #$##  #
## ..  #
# $**$ #
#  .. ##
#  ##$#
##    #
 ######
