###############
#             #
# $.$.$.$.$.# #
# .$.$.$.$.$  #
# $.$.$.$.$.#@#
# .$.$.$.$.$  #
# $.$.$.$.$.# #
#             #
###############
