   #######
   # ... #
####$##$ ##
#    $    #
# #$@.* # #
#   $*. # #
## # .* # #
 #$ ####  #
 #       ##
 #########
