#######
#  .  #
# $.$ #
# $*$ #
#..*..#
#$$*$ #
#  .  #
# $. @#
#######
