#######
#  .  #
# $*$.#
#  .. #
#$$*$$#
# ..  #
#.$*$ #
#  . @#
#######
