       #
      ###
     ##  #
    #  $ ##
   #  $.$  #
  ## $.*.$  #
 #  $.*.*.$ ##
## $.*.*.*.$ ##
 ## $.*.*.$  #
  #  $.*.$ ##
   #  $.$  #
    ## $  #
     # @##
      ###
       #
