#######
#  *  #
#  *  #
# $*$ #
#*...*#
# $.$ #
# $.$ #
#  . @#
#######
