#########
##  @  ##
# $ $.# #
#  $.#. #
# $.#.$ #
# .*.$  #
# #.$ $ #
##     ##
#########
