#######
#  .  #
# $*$ #
# $.$ #
# ... #
#.$.$.#
#$$*$ #
#  . @#
#######
