###############
#  .........  #
# $.$$$$$$$$$ #
# $.$.......$ #
# $.$.$$$$$.$ #
# $.$.$...$.$ #
# $.$.$*$.$.$@#
# $.$...$.$.$ #
# $.$$$$$.$.$ #
# $.......$.$ #
# $$$$$$$$$.$ #
#  .........  #
###############
