 ########
##  @#  #
#  ###$ ##
#  * *   #
# * * *  #
#  * * . #
###   ####
  #####
