##########
#        #
# $#$#$#$##
#. .$...$.#
#. .$...$.#
# $#$#$#$@#
#        ##
##########
