###########
#  $  *.* #
#  $  *.* #
#  $  *.*@#
#  $  *.* #
## $  *.* #
 ##########
