 ####   ####
##  #####  #
# $ $   $$ #
#    ## #  ###
##$#.....$   #
 # #.....#  $##
 # #.....# $$ #
 # ### ###    #
 #    @    #$ #
 #  #  $ ###  #
 #### $ $ $ $ #
    #####     #
        #######
