 ############
 # @# ......#
 #$ #...* $ #
 #   $ ##  ##
 # $ $  ## #
## ### $#  #
# $# $    $#
#     ##   #
####  ######
   ####
