   #########
   #@      #
 ### ##  # ##
 # $$ # $#  ##
 #    # $ #$ #
 #  # # #    #
 ## # $  $ $ #
  # #   ###  ##
  # ##...##$  #
###$$ ..### # #
#  $  ...##   #
#   ##....#####
###########
