 ####
 #  ########
 #   $     ###
 # ##$ ###   #
 #    #...$  ##
 #$ @ #...# $ ##
##  #  ...#$   #
# $$  $#..  #  #
# #  $ #..$ $  #
#  $  ##..#  ###
### #$  $ ####
  #    #  #
  #########
