#########
#   ## @#
# $  $  #
## *.#$ ##
 # #.*   #
 # .. $# #
 #####   #
     #####
