  ####
  #  ########
 ##    $    #
 # $# #.# # #
 #  ...*. $ #
## #$##.##  #
# $     $ @ #
#   ###  #  #
##### #######
