   ###### #####
   #    ###   #
   # #$     $ #
 ### $ ##### ##
 #   #.##     #
 # $##.##  #$ #
 #  ..... $#  #
##$ ##.##  ####
#  $ #.#####
#   $ @ #
#####   #
    #####
