#########
#  #    ###
#  #  #   ###
# .   # $ $ ###
#..#  # $ $   #
#..   # @$ $  #
#..#  ##$# $  #
#..  ##   $ ###
#..#    $$# #
#    ##     #
#  ##########
#  #
####
