     #####
######   ######
#   #  $ ##   #
# $ $ $ #   $ ##
#  $# @ $ $$#  #
## $  #     $$ #
#..#$#### #$#  #
#....  #  #   ##
#....   $$#####
#...###   #
#...# #####
#####
