     #####
   ###   ####
 ### $ $ #  #
##   .#     #
# $# ..# $  #
#@$  ...#  ##
# $# #...#$ #
##   $ $    #
 #### # #####
    #   #
    #####
