    ####
  ### @####
 #  #   #  #
 #$ $ $$$ $#
 #  #.#.#  #
 # #.....# #
 # #.....# #
#   #...#   #
# $  # #  $ #
 #  $ $ $  #
  #$ $ $ $#
  #       #
  #########
