             #
            ##
           ###
          #   #
   ######## # #
  # $ $ $ $   #
 ## # # # #$##
###.......   ##
 ## #.#.#.#@$#
  # $ $ $ $   #
   ######## # #
          #   #
           ###
            ##
             #
