    ##   ##
   ######  #
####  $ $  ####
 ### *.*.* ###
  ## .$ $. ##
   # *.*.* #
   #  $ $  #
   ### @ ###
     #####
       #
