#####       ####
#   #########  #
#              #
## ##########  #
 # # * . * ## ##
 # #  * *  ## #
 # # * * * ## #
 # #  * *  ## #
 # # * * * ## #
 # #  * *  ## ##
 # # * * *     #
 #$#  * *  #   #
 #@  * * * #  ##
 ##############
