########
#####@.#
####.$$#
#### $ #
### .# #
###    #
###  ###
########
