########
####  .#
#### #.#
###   .#
### $# #
## $$  #
## @ ###
########
