########
####  ##
# $ .  #
#@* # .#
##$$$  #
##.  . #
#####  #
########
