########
#####  #
#+$ *  #
# #.   #
# $ .$##
##$#  ##
##  . ##
########
