#########
######  #
####@*  #
####$.  #
##  .*  #
##  $* ##
####  ###
####  ###
#########
