#########
####  ###
#### *@ #
#### *  #
##  *.$ #
##  $. ##
####  ###
####  ###
#########
