#########
####  ###
####.  ##
#@$    ##
# .** ###
#   $ ###
##.$#####
##  #####
#########
