########
##.  ###
##.# ###
##  $###
## #@###
##  $  #
##. $  #
########
