#########
#### @  #
####$   #
####.*.##
##  * $##
##  $. ##
####  ###
####  ###
#########
