########
#   ####
# #. ###
#  .   #
# $ $  #
#*$#$###
#. .@###
########
