########
## @####
##$$####
##   ###
##$ *. #
## $   #
#  .####
#. .####
#  #####
########
