########
#### @##
####$ ##
#### $##
####.$ #
#  .. .#
# $  $ #
##### .#
#####  #
########
