########
#..  ###
# #$$###
#  $ $ #
#.#. $@#
#  . ###
##   ###
########
