########
# . ####
#  $   #
#$.*.  #
#  $$###
#. *@###
#  #####
########
