########
#  . ###
# $ * ##
##@*. ##
##$*.  #
##  $  #
##  ####
########
