########
###  ###
### .$ #
# .$$*@#
#.  . ##
#  $*###
#    ###
########
