########
##  ####
## *.$ #
#  .*$@#
#  *# ##
#      #
####   #
########
