########
###@...#
# $$#  #
#   #$$#
## $   #
##  # .#
###  .##
########
