########
#.  ####
#.#    #
#.#    #
#.$ $# #
#$$$   #
#.@#####
########
