########
#   ####
# $ ####
##$    #
## # . #
#@$.$. #
# $.. ##
########
