########
## @ . #
## * $ #
# $ #.##
#.# $ ##
#    ###
#. $ ###
########
