########
##    ##
##$ # .#
# $  #.#
#@$$  .#
##  $..#
##  ####
########
