########
####@ ##
#### .##
## $$  #
##   . #
###$#. #
###   ##
########
