########
###  ###
###   .#
#. ..# #
#$ # $ #
# $$  ##
#+$   ##
########
