########
#####  #
# *   .#
# @*#$ #
#   $  #
##.# $ #
##.  ###
########
