########
###  . #
#  .*  #
# $.*  #
###$.$##
###@$  #
####   #
########
