########
###  ###
##@$ ###
#.$$ $ #
#  * # #
## . $.#
## . . #
########
