########
# .$ ###
# $ $  #
#.# *..#
#  $ $@#
##  .###
##  ####
########
