########
####--##
####--##
#---$--#
#--$$#-#
###.--+#
###.-###
########
