########
#   . ##
#  $$  #
## #. .#
##.$*  #
###@$*##
###   ##
########
