########
###  ###
###  ###
#  $. ##
#  * $ #
# #$$+.#
#.  .$ #
########
