########
####@ .#
####$$ #
###  #.#
## $ $ #
#  *$..#
#    . #
########
