########
##    ##
##. $ .#
#@$ *  #
# #$* ##
#.$ . ##
###  ###
########
