########
###  ###
### .  #
# $ $ *#
#@$ #. #
##.. $ #
##.$  ##
########
