########
#. #####
# $@$  #
#.$#$  #
#    # #
# .# $ #
# .. ###
########
