########
# * . ##
#  $  ##
# # $ ##
#.  #$@#
#.#  $ #
#.  ####
########
