########
###  ###
##   * #
#@$$*  #
# $. # #
##$. # #
## .  .#
########
