########
###.@.##
# $$#$##
#      #
### .  #
### *  #
########
