########
##     #
# $ $  #
#.# $$##
#  *$@##
# #. ###
#... ###
########
