########
# . ####
# $ ####
# $$@  #
#  # # #
#  ** .#
#. .$ ##
########
