########
##  ####
# .$ ###
#*   $ #
# .#$+ #
# .  $##
#.$   ##
########
