########
#####  #
## .. .#
##$**  #
#   # ##
# $$ $ #
## .@  #
########
