########
# .#####
#   $ ##
# .$.*@#
#   $$ #
##.$* ##
## .  ##
########
