########
####   #
##. $..#
## # . #
## $$  #
####@$##
####  ##
########
