########
####  ##
#@  $.##
# * * ##
## *$. #
## $ $.#
## .   #
########
