########
#  * ###
#. $ ###
# *$ ###
#  .* ##
##. $@ #
## $.  #
########
