#######
## .  #
#@$*  #
#*$.$ #
# *.. #
#.$ $##
#    ##
#######
