#######
#.    #
# *$. #
#$ $  #
#..$.##
#.$ $##
#  *@##
#######
