########
###  ###
#@ *.  #
#  $ $.#
# ## .$#
# # $  #
# $. .##
########
