########
###    #
###. * #
##@* * #
##$#$. #
#. $   #
#   $.##
########
