########
##  @ ##
##*$*$##
# .# . #
#  ..  #
# $ $$ #
### . ##
########
