########
###  ###
#  $.###
#*..*@##
# $.#  #
#  $$  #
# .  $ #
########
