########
#### . #
## $ $ #
# $ *+##
#  .$$ #
#. * . #
###   ##
########
