########
###  ###
### .* #
#  $ $ #
#  $#  #
# *$.  #
#@* ..##
########
