########
#@$.   #
#.$* $ #
# . . ##
#.$# ###
# $ $###
# .  ###
########
