########
### .###
### @###
#. $.###
# #  ###
# $$ ###
###  ###
########
