#########
####.@. #
### $ $ #
###  $ ##
####  ###
####.$###
####. ###
####  ###
#########
