########
#.@ ####
# *.$ ##
# * $. #
# *#$ .#
#$     #
#   ####
########
