########
#@ #####
#$$   ##
#. * .##
#..$#  #
# $ $ .#
## . $ #
########
