########
#  .$@##
# *$** #
#      #
#  .#$##
##$  .##
## . ###
########
