########
####   #
#   $ $#
# .*#..#
## .  $#
## $$  #
###@* .#
########
