########
####@. #
#### $$#
#   $$ #
#..$#  #
#  .*$ #
## .  .#
########
