########
#@. * ##
#  $.  #
## .$$.#
## $#  #
## *  $#
#### . #
########
