########
## .$  #
#  .  .#
#.*$#  #
# $.$$##
#  .$@##
#  #####
########
