########
###@ ###
#  $** #
#. * * #
# $#   #
#$ ..  #
#   ####
########
