########
#. $   #####
#  .... $  #
##$ $  $   #
## *########
##@ ######
##########
