########
## . ###
# $ * ##
#.. $ ##
# *$.*@#
# $  $ #
##  . ##
########
