########
## .$ ##
# $ . ##
# ..* ##
# * $$ #
## *.$ #
###   @#
########
