########
##  ####
# * .$ #
#   *$@#
#  *$. #
## $.* #
###  . #
########
