########
## @ ###
##$. . #
## $ $ #
#  *$* #
#. .$ ##
# $ ..##
########
