########
#  #####
#. $ ###
# * * ##
# * .. #
# $$$  #
#@* .  #
########
