########
### . ##
# $$.  #
# $. . #
#  *.$ #
# *$ * #
##@ ####
########
