########
#  #####
# $$.$ #
#... $.#
#   $$@#
# .*.$ #
#   ####
########
