########
#### @##
# .$*$##
# .$. ##
# .$.$##
#  $.  #
# $ .  #
########
