########
##  ####
#   * ##
#. *  ##
#  .*. #
# $*$$ #
#   *@##
########
