########
##. ####
#     ##
# .$*. #
# $@$$ #
# *$. ##
# $ ..##
########
