########
##  ####
# $. * #
#. $   #
#  *$..#
#*.$@$ #
#   ####
########
