########
###  ###
## * ###
#  $ $ #
#   **+#
#  **. #
# .  $ #
########
