########
####.  #
## $ $ #
##.$. ##
##.$# ##
##  #@##
##    ##
########
