########
#  #####
#@.$. ##
# *$. ##
# $ .$##
#. $*  #
# $ .  #
########
