########
#  * ###
#   .$ #
#  * * #
##.$#$@#
##$$.. #
##   . #
########
