########
####  ##
#  * * #
# $ .$ #
# #* * #
#+$ *  #
##  .  #
########
