########
## @####
##$$   #
#  $  $#
#  #**.#
#* .*. #
# .    #
########
