########
## .  ##
##  ** #
##  .$ #
##$#$  #
# *.+$*#
#      #
########
