########
#    ###
#. **  #
# $$.  #
##+.#$ #
##$$ * #
##   . #
########
