#########
#  .######
#  $ $ @ #
##* ..*..#
#  $ $ $ #
# # ######
#   #####
#########
