########
## + ###
##$.$###
## * ###
## * ###
# .$   #
#$ $.. #
#.  $ ##
# $. ###
########
