########
###  ###
###    #
###$  .#
###  #.#
## $$#.#
##@$.  #
########
