########
## . ###
## .$###
## * ###
## * ###
## . ###
# . $###
# * $@##
# $*$* #
#  .   #
########
