 #####
##@. #
##$.$#
## * #
## * #
# .$ ##
#  *  #
# *   #
# *  ##
######
