 ######
 # .  ##
##$.$  ##
#  ..$. #
# $$ *  #
##@.*$ ##
 ##   ##
  #####
