#########
#  ######
# @######
#$ ######
# $  ####
#.$  ####
# #.#####
#  .#####
#########
