#########
#########
##   ####
# .#$####
#  .  ###
# .$$ ###
## @#####
##  #####
#########
