#######
## @###
##$ ###
## *  #
## *. #
# .$ ##
#    ##
#######
#######
