#########
###  ####
# *$ ####
#.$ $  ##
#  . . ##
#@ ######
#########
#########
