########
##   ###
##  ..##
## $ $##
## #$.@#
##$#   #
##.  ###
########
