########
#+ #####
#*$#####
#  #####
# $#####
#  #####
#    ###
#.$. ###
#  #####
########
