########
##. ####
##    .#
#.  ## #
#    $ #
###$$###
### @###
########
########
