########
###  ###
###  ###
# $$ ###
#.$. ###
#@##  ##
#.    ##
####  ##
########
