#########
##  #####
##@.#####
##  #####
# $$#####
#      ##
##.$.# ##
####   ##
#########
