########
## @####
##$ ####
## $ $ #
##.$.# #
# .   .#
#   ####
########
