#########
###  ####
#    ####
# #  ####
# * #####
##.$  ###
## $@.###
##  #####
#########
