#########
###  ####
###@$####
#  $.####
#  * ####
## $. ###
## .# ###
###   ###
#########
