#########
###   ###
###  .###
#@$  ####
# #* ####
#.$.$####
##   ####
##  #####
#########
