#########
##  #####
##    ###
##  #$###
### #  ##
###.#$ ##
##   $@##
##.. ####
#########
