########
##  ####
##    ##
#  .# ##
# #$  ##
#. . ###
##$#$###
##@  ###
########
