#########
####  ###
####  ###
#    $###
#  # .###
## * .###
##$*  ###
##@ #####
#########
