#######
#.  ###
# #  ##
#... ##
# # $##
# $$$ #
###@  #
####  #
#######
