#########
##  #####
##  #####
#@.$  ###
#. .# ###
# $$# ###
## .$ ###
##  #####
#########
