#########
#########
# *  ####
#@$  ####
# .# ####
##*   ###
# $   ###
# . #####
#########
