#######
##@ ###
##$$###
# . . #
# .$. #
##   ##
###$  #
###   #
#######
