#########
###@  ###
# .$$ ###
#   $ ###
###$#.###
###  .###
### # ###
###  .###
#########
