#######
#.  ###
#.#  ##
#.*  ##
# #  ##
# $ $##
###$@ #
###   #
#######
