#########
##  #####
##     .#
##.$. $ #
# $#$####
# . @####
#  ######
#########
