########
########
###@ ###
###  ###
#   $###
# .*.  #
## $$  #
###. ###
###  ###
########
