#########
#  ######
#  $@####
#.$..####
#* #.####
# $  ####
#  $#####
#   #####
#########
