#######
#    ##
# $$ ##
## *.##
# .* ##
# $ .##
### @##
###  ##
#######
