########
##  ####
## . ###
## * ###
## $.###
#  $ #
# $.*#
###  ###
###@ ###
########
