########
#+ $ ###
# $  ###
# #  ###
#  $####
#.# ####
#.  ####
########
