########
##@ *  #
##. $  #
###  ###
### $  #
###.$. #
###  ###
########
