########
#   ####
#     ##
## ##.##
# $$  ##
#  *.@##
###  ###
###  ###
########
