#########
###  .###
#@$ #.###
# $ #.###
## $# ###
##    ###
## #  ###
##   ####
#########
