########
## @ .##
##$##$##
## # .##
## $$ ##
#   ..##
#    ###
#  #####
########
