#######
###@  #
# . . #
#  $ ##
###$.##
#    ##
# $$.##
###  ##
#######
