########
##  ####
##  ####
#  $$@##
#   #$##
#   *.##
##.## ##
##.   ##
########
