#########
####  ###
## . .###
# $ $ ###
# #  ####
# #$$####
# #  ####
#. .@####
#########
