########
## .####
##.   ##
#.. # ##
# # # ##
# $ $ ##
## $$###
##@  ###
########
