########
### .###
#  .   #
# *. # #
## $   #
####$$##
####@ ##
########
