#########
# @######
# ..   ##
# $ $  ##
##.# ####
##.$ ####
## #$####
##   ####
#########
