#########
#####  ##
#### $ ##
##. . .##
# $#. ###
#@$   ###
###$  ###
###  ####
#########
