#########
##   ####
#  . ####
# # $####
#  *@####
### $####
###.$  ##
###  . ##
#########
