#########
###  ####
# $  ####
#   $####
#.#$@####
#.#   ###
#.#$  ###
#.  #####
#########
