########
########
#.   ###
#.##   #
# ##$@ #
# $ $$##
#..   ##
###  ###
########
