#########
###.  ###
### # ###
###   ###
## $#.###
##    ###
# $$#.###
#@$.  ###
#########
