#########
###  ####
###    ##
###$@# ##
#  .* .##
#  $$ ###
### .####
###  ####
#########
