#########
#####  .#
###     #
###* $ ##
### . ###
### *$###
####@ ###
####  ###
#########
