#######
###  ##
###$.##
# @$ ##
# * . #
### . #
###  ##
###  ##
### $##
###  ##
#######
