#######
#    ##
#  * ##
## .###
## $ @#
## * .#
##  ###
##$ ###
##  ###
#######
#######
