#########
### @####
### $####
###$ ####
## $ ####
##.#   ##
#. $   ##
#  . .###
#########
