#######
###  ##
###$.##
#@ $ ##
# $ . #
###.. #
###  ##
###  ##
### $##
###  ##
#######
