#########
###  ####
#  * ####
#  . ####
#.$ #####
# *$ ####
#$ # ####
# +  ####
#########
