#########
##  #####
##.$@####
# . $.###
# $*  ###
##.#$ ###
##    ###
####  ###
#########
