#########
#. . ####
# $  ####
##  $ ###
## *#@###
##$.$.###
##   ####
###  ####
#########
