#########
####  ###
## . .###
# $ $ ###
#.# $####
#..$ ####
#@$  ####
###  ####
#########
