#######
##  ###
##  ###
## .  #
## *. #
# *$$##
#@$   #
### . #
#######
