########
#### . #
# @$   #
# $ . ##
## *$###
##*. ###
##  ####
##  ####
########
