#########
## .#####
##  #####
# * $ ###
#   #.###
# *$  ###
## @* ###
##  #####
#########
