#######
###   #
###$  #
# $ * #
#@*$. #
##  . #
##. $.#
#######
