#########
####  ###
# $   ###
#  ## ###
# $##.###
##@# ..##
##$    ##
##   ####
#########
