#####
#   #
#   #
# *$###
# . * #
#.$$@ #
#  .###
#####
