#########
##@  ####
##$#$####
#. . ####
# #$  ###
#   #.###
##    ###
## $ .###
#########
