#########
# @######
#  .   ##
# $ .# ##
##.# $ ##
##.$ ####
## #$####
##   ####
#########
