#########
##  #####
## . ####
# *.$####
# #* ####
#@#    ##
#  $ # ##
####   ##
#########
