########
####@ ##
#...  ##
# ##  ##
#  $.###
## $ ###
##$$  ##
##    ##
########
