########
##  ####
## $   #
#    * #
# ## .##
#  *. ##
### $###
### @###
########
