########
####@ ##
####$$##
###.  ##
#.  #.##
#      #
## #$# #
##.  $ #
########
