#########
##@ #####
##$$ ####
## #   ##
#  *$. ##
#.    ###
### # ###
###  .###
#########
