#########
##  #####
##$ #####
## .  .##
##*  # ##
# $.#  ##
# $   ###
#@ ######
#########
