########
###   ##
# . .$##
# $# $@#
##  .# #
###    #
###  ###
########
