#########
# @######
# .  ####
# $#$  ##
##.$ . ##
## #$ ###
##.   ###
####  ###
#########
