########
#  #####
# $ @ ##
# *## ##
# *   ##
#. #$ ##
#  . ###
#  #####
########
