#########
#####   #
#### $# #
####.  .#
#     ###
#  ** ###
### #$###
### @ ###
#########
