########
####.  #
# $    #
#@ *#$##
###    #
###.   #
#####  #
########
