########
##   ###
##@$$###
# $ $ ##
# # # ##
#.  # ##
#   ..##
##. ####
########
