#########
##   ####
# ..   ##
#    $ ##
## #$####
##.$@####
## #$####
##.  ####
#########
