#########
### .. ##
# . .  ##
# $   ###
###$# ###
###@$ ###
###$# ###
###   ###
#########
