#########
##   ####
## . * ##
###$$$@##
#  . ####
#    ####
## # ####
##.  ####
#########
