#########
##  #####
## $  ###
# $...###
#. $  ###
#  #* ###
##$# ####
##@  ####
#########
