#########
#   #####
# . #####
##   $ ##
##**#$@##
##.  $ ##
##.  ####
###  ####
#########
