#########
## @#####
##.$ ####
##* * ###
# $ $ ###
#   # ###
# .  .###
##  #####
#########
