#########
##   ####
##*  ####
#. * ####
# # $ ###
# #$* ###
#@  . ###
###  ####
#########
