#######
## @###
##  ###
##$$###
##.  ##
# .* ##
#  $. #
# * # #
###   #
#######
