########
#.   .##
#.# # ##
#.*   ##
#$ $ ###
#  $ ###
##$@####
##  ####
########
