#########
###  ####
# *..####
#@#$. ###
#$ $  ###
#.    ###
# #$#####
#   #####
#########
