########
# @ ####
# $$   #
##.#$  #
##. .$##
##  . ##
###  ###
########
