#########
#  ######
#   $ ###
#$  . ###
#. #$####
#. *@####
##$ .####
##   ####
#########
