#########
###  ####
#+$* ####
#$*   ###
# $#  ###
#.   ####
#  . ####
###  ####
#########
