#########
##@  ####
##$$$ ###
##  #.###
#     ###
# #$ .###
#..$ ####
### .####
#########
