########
###.  .#
#    # #
# #.$  #
# $.$###
##@$ ###
##  ####
########
