#########
##  #####
##  #####
#     ###
#  $#.###
# $@# ###
##*$$ ###
##. ..###
#########
