#########
###@ ####
###$$####
#  $  ###
#..*  ###
#   # ###
# * # ###
###  .###
#########
