#########
####@ ###
##. $$###
## #* ###
##    ###
#.$. .###
# # $ ###
#   #####
#########
