#########
##  .####
##$#+  ##
#  $$  ##
#. .* ###
#$  #####
#  ######
#  ######
#########
