#########
#### .###
####  ###
## . . ##
## # * ##
##$$ *###
#   $@###
#   #####
#########
