#########
##. . ###
##. # ###
#  $ $###
# $@$ ###
####$  ##
####. .##
#####  ##
#########
