#########
#@    .##
#. $.# ##
# *$$  ##
##  #####
##$.#####
##  #####
##  #####
#########
