########
###  .##
# $ #*##
#@*   ##
##*#   #
##     #
#####  #
########
