#######
##@ ###
## $###
##$ ###
##  ###
##$ ###
# $ ###
#.$  ##
#   . #
###...#
#######
