#######
#   ###
#.  ###
# $.  #
# **  #
##   ##
###$*@#
###   #
#######
