#########
###@ ####
###$$  ##
###.$  ##
#   # ###
# *.$.###
##    ###
####. ###
#########
