#########
###   ###
#@ $$ ###
# $   ###
###$# ###
### *. ##
### .. ##
### .####
#########
