#########
###  ####
### .$@##
### *..##
#  $ #.##
# $ $  ##
###  ####
###  ####
#########
