########
### .  #
#..* # #
# #    #
# $$  ##
### $###
###@ ###
########
