#########
####   ##
#### $ ##
## $  ###
##.# $###
#  *  ###
#@.*. ###
###  ####
#########
