#########
###  ####
### .. ##
#   $* ##
#  $#@###
##$.$ ###
## . ####
###  ####
#########
