#########
###  .###
### # ###
# $$  ###
# . ..###
### $. ##
###$$  ##
### @####
#########
