########
## @####
##$$####
##  ####
##.$ ###
# . . .#
#  $   #
### *###
###  ###
########
