########
### @###
### $###
###* ###
###  ###
###$.###
###    #
# $$.. #
#  .  ##
########
