#######
#  ####
#. .* #
#  *$.#
##$.$@#
## $ ##
##   ##
##   ##
#######
