########
## @ ###
##$#$  #
#    # #
# ..$$.#
## . ###
###  ###
########
