#######
##@. ##
##$.$##
## * ##
## $. #
#  *  #
#   * #
##  ###
#######
