#######
# @ ###
#*.$  #
# $$  #
#.. ###
#.* ###
#  $###
#   ###
#######
