######
#. ###
#  $@#
# *$.#
# * ##
# * ##
# * *#
#    #
#   ##
######
