########
##.@ ###
##*#$###
## # $ #
#      #
# . #  #
## ## ##
##    ##
########
