########
#. #####
#  $ ###
#   $ ##
#     ##
# ## ###
#$##$ ##
# ...@##
########
