#########
##    ###
##. #  ##
# .$+# ##
#  $*# ##
### $  ##
###  ####
###  ####
#########
