#########
### .  ##
#  $ # ##
#. *$ .##
## # ####
##$#  ###
## @  ###
####  ###
#########
