#########
##@ #####
##$$   ##
##     ##
##  #.###
#  $#.###
#   #*###
###  .###
#########
