#########
###  .###
###$$ ###
###@#. ##
#  * . ##
#.   $ ##
####$# ##
####   ##
#########
