########
#  #####
# $  ###
# *# ###
# *@$  #
#. ### #
#     .#
#  #####
########
