########
#  #####
#..   ##
#.##$ ##
#+##   #
#  $$  #
##  $ ##
##  ####
########
