#########
####  ###
# $   ###
#  #. ###
# $##*###
##@# ..##
##$    ##
##   ####
#########
