#########
## . ####
#  .$####
#. $   ##
##.#$  ##
# $# ####
# @  ####
#  ######
#########
