#########
#  ######
#   #####
#   .####
## $  ###
### .$###
####.$@ #
#### *  #
####  ###
#########
