#########
###  .###
### # ###
# $$  ###
#.  *.###
#.$#  ###
#  #$####
#@   ####
#########
