########
####  @#
#  .*$ #
#  $# ##
##$.  ##
## .  ##
####  ##
########
