#########
##    ###
##$$ .###
##. # ###
## *$.###
# . # ###
#  $#@###
###   ###
#########
