#########
##   ####
##.$*  ##
##.$   ##
##@#$####
# .. ####
# #$ ####
#    ####
#########
