#########
###  ####
#.   ####
# #  ####
#   $####
# *   ###
#$*#$ ###
#@.. ####
#########
