########
#@   .##
#$ ## ##
# * $ ##
# *  ###
# .#$###
#.   ###
#  #####
########
