########
##  ####
#   $ ##
# .$$+##
#.$. ###
# ##  ##
#.$   ##
####  ##
########
