########
# . ####
#    $@#
##  #$ #
##.$* ##
##  . ##
####  ##
########
