#########
##. $ ###
##.$  ###
#@*$# ###
# #  .###
# $ # ###
##   .###
##  #####
#########
