#########
####  ###
##@$. ###
##$#$ ###
#  . .###
#  #$ ###
##$.  ###
##  . ###
#########
