#########
#. ######
#.   $ ##
#  ..  ##
###$#$###
###@$  ##
####$  ##
#### . ##
#########
