########
#  #####
# .    #
# $ .* #
# #.#$##
#  .$@##
### $###
###  ###
########
