########
####  ##
#+$   ##
# ##. ##
#  #  ##
#$* * ##
#   $.##
####  ##
########
