#########
#@ ######
# .   ###
#$ #$ ###
# $. ####
#.* $####
# #  ####
#  . ####
#########
