#########
#####  ##
####.  ##
####    #
# *. $# #
#@$ * . #
##### $##
#####  ##
#########
