########
##### .#
#  $   #
#    *.#
##*# # #
##@$  .#
#### $##
####  ##
########
