#########
##  #####
##  $ ###
##  #.###
##  $ ###
## # .###
#@$$..###
#.$   ###
#########
