#########
# . #####
# $  $ ##
## .$$@##
##  #.###
## .  ###
### #$###
###.  ###
#########
