#########
###. ####
#..  ####
#  * ####
## #$ ###
##    ###
## #$$ ##
##.  $@##
#########
