#########
###. ####
#. $ ####
# @$ ####
## # $ ##
## # . ##
##.$  ###
##  $.###
#########
