#########
####   ##
##  $  ##
## $+*###
# *.# ###
#  $ .###
### # ###
###   ###
#########
