########
###  .##
#   #.##
# .$# ##
##$$ $ #
##  @  #
### .###
########
