#########
####  ###
####  ###
#    $$ #
#  *. # #
### .$ .#
####$ ###
####.@###
#########
