########
#  #####
# $    #
#. .## #
##$ $  #
## ..  #
##$*####
##@ ####
########
