#########
#####  ##
##### .##
#####@$##
#  . *  #
# * *$  #
##    ###
####  ###
#########
