#########
###@ ####
###$$####
### . ###
# .$.* ##
#  $ # ##
###   .##
###    ##
#########
