#########
####  ###
### * ###
# $   ###
#@ **.  #
###  .$ #
####  ###
####  ###
#########
