########
### @###
#  $*###
#  $.  #
###$. .#
### .###
###  ###
###$ ###
###  ###
###  ###
########
