########
##@ ####
##$$####
# $   ##
# #  .##
#.   ###
### .###
########
