########
###@ ###
#..$$###
#  $   #
#.#$  .#
#    ###
##  ####
########
