########
#  #####
#    $ #
#.$... #
## .$ ##
##$ ####
## $ ###
##  @###
########
