########
###  ###
### $###
###. ###
###.$###
##   $ #
# ..*$@#
#    ###
##   ###
########
