########
####  ##
####  ##
### $+ #
### .$ #
###*  ##
##  * ##
# .$ ###
#   ####
########
