########
###  ###
###  ###
###  ###
#  $.###
#   .$@#
###$.$.#
### .###
###$ ###
###  ###
########
