########
### @###
### .###
##  $###
# ** ###
#  *   #
##  $  #
###. ###
###  ###
########
