#########
##  #####
##. #####
# $$$   #
#+.. $  #
#  *#####
#   #####
##  #####
#########
