########
####@ ##
## . ..#
##   * #
####$$ #
#### $##
####  ##
####  ##
####  ##
########
