#########
##  #####
##$ #####
## .#####
## . $@.#
## *$   #
# $ #####
#.  #####
#  ######
#########
