########
####   #
## $   #
##..* ##
## $  ##
## .$###
#@** ###
#   ####
########
