#######
##  ###
##  ###
# $ ###
# .$  #
# .$. #
## *. #
## *$##
### @##
#######
