#######
### @##
### $##
###$ ##
###  ##
# $$. #
# .$. #
# . * #
### . #
#######
