######
#   ##
#   ##
# $ ##
#.* ##
#$* ##
#@* ##
## $ #
##.. #
###  #
######
