#########
#  ######
# $@$ ###
#.*#$ ###
#.$. .###
# .$  ###
#   #####
#  ######
#########
