#########
###  ####
###$ ####
###  $ ##
###$.. ##
#  @*** #
#  .    #
#########
#########
