#######
#  ####
#  $@##
#  *$##
##$. .#
## *$ #
## . ##
## . ##
##  ###
#######
