########
### @###
###$.###
### . ##
###$. ##
##  *$ #
# *$   #
#  .  ##
########
