#########
##.  ####
## #$####
##.$ ####
##.#  ###
# *   ###
#  #$  ##
#@$ .  ##
#########
