#########
##.  ####
## # ####
#    ####
# .#$$ ##
# .. *@##
## #$$###
##    ###
#########
