#########
#   #####
# # $+###
#  *$$###
### #.. #
###.    #
###  $ ##
###  ####
#########
