########
###@ .##
### $$ #
## .*  #
## #  ##
##. *$##
##    ##
########
