#########
### .. ##
###@ #$##
# *$$ .##
#    # ##
###$ . ##
### # ###
###   ###
#########
