#########
###  +###
###$#$###
##   * ##
##     ##
#   #. ##
# $$#.###
###  .###
#########
