#########
###  .###
### # ###
#   * ###
# *  $###
#  #.  ##
##$#*  ##
## @ ####
#########
