#########
###  ####
#  ..####
# $$$####
#.#. $.##
#    # ##
##  $#@##
####   ##
#########
