########
####   #
##   $ #
# $ $ ##
#@#$$ ##
#... ###
#.## ###
#.   ###
########
