########
##  ####
##. ####
#      #
# *  # #
# .#$# #
#*$  $ #
#@.#####
########
