########
#  #####
#  $@###
#  $$$ #
## # # #
## *.# #
##  ...#
##   ###
########
