########
##@  ###
##$  ###
#  $$$ #
#.#.   #
#...$###
# ## ###
#    ###
########
