#########
#  ######
#   $@###
#..#  ###
#   $####
#.$.$.###
# $ # ###
###   ###
#########
