########
###  ###
###  $ #
##  $# #
##.#.# #
#@$ *. #
# $  . #
#####  #
########
