########
## .$  #
##  $ @#
#  $$###
#.#  ###
#...$###
# ## ###
#    ###
########
