########
###--###
###----#
#+.$-#.#
#-##$*-#
#-$--.-#
##--$-##
##--####
########
