########
####  ##
##+$  ##
##$#*. #
#   $  #
# * . ##
## ## ##
##    ##
########
