########
###  ###
# .  . #
# $*$# #
##@# # #
## $.  #
### .$ #
###  ###
########
