########
###  ###
#    *.#
#  $.# #
##.# # #
## $.  #
###@$$##
###   ##
########
