########
####   #
## ..  #
##$.  ##
#  *# ##
#  $  ##
##$##$##
##+   ##
########
