#########
###  ####
###.    #
#  $    #
# .*$####
##.  ####
## $#####
##* #####
##@ #####
#########
