#########
####  ###
####. . #
####.$  #
####  ###
#@ $$ ###
# *.  ###
### $ ###
####  ###
#########
