########
####@ ##
##  $.##
#.  $  #
#$$# ..#
#  ##.##
#   $ ##
#  #####
########
