#########
## . ####
##$ . ###
##  $ ###
## #..###
## #$ ###
# $$ .###
#@$ . ###
#########
