#########
###  ####
# $  ####
#  $ ####
#..# ####
#$$*  ###
#+.#  ###
# $ . ###
#########
