########
#### @##
## $$$ #
# .* # #
#     .#
###  # #
####  .#
########
