#########
##@  ####
##$$$####
## $  ###
# $ #.###
# $ #.###
#   ..###
##  ..###
#########
