#########
### @####
###$$####
#   $ ###
#.* . ###
#$  # ###
# .*#.###
#     ###
#########
