#########
###. ####
#    ####
#  $ ####
# $#$####
#   $@###
#$ .# ###
#. .*.###
#########
