#########
#@ ######
#$ $ ####
# $.. ###
# #$. ###
#.$   ###
# #$.####
#  . ####
#########
