########
####  ##
# * . ##
#     ##
# $##.##
#*$ ..##
#@$ $ ##
####  ##
########
