########
# +.####
#..    #
## #$$ #
## $ $##
###    #
####   #
########
