#########
###  ####
###$@####
#   $   #
# # **  #
#.. . ###
##$# ####
##   ####
#########
