########
## @####
##$.####
## $ ###
##.$.###
# .$. ##
#  $$  #
### .  #
###  ###
########
