########
###@ ###
#  *$###
#  *   #
##$ *  #
## .$###
## .  ##
###  .##
########
