########
## . ###
#  . ###
#.$ $@##
## **$ #
##$    #
## . ###
###  ###
########
