########
###@ ###
## .$###
##$*.  #
## $.  #
#   * ##
#  $. ##
####  ##
########
