########
#  #####
#. . ###
#  $$ ##
## *+$.#
##  $  #
##### $#
#####  #
#####. #
########
