########
###@ ###
###$$###
###  ###
###*.  #
#  *.* #
#. $  ##
#    ###
#  #####
########
