########
#### .##
####  ##
### $ ##
# $ . ##
#@*** ##
##  $  #
####.  #
#####  #
########
