########
##@  ###
## . . #
##$*$$ #
## . ###
#.$. ###
#   $###
##   ###
########
