########
#####  #
###  . #
###*.  #
#  .$$##
#   .* #
###$$  #
### @###
########
