########
#  #####
# *  ###
# .. ###
##$.$$ #
##.  *@#
## $ ###
##  ####
##  ####
########
