########
##  ####
## ..  #
# $.*$ #
#   . ##
### * ##
### $###
###$ ###
###@ ###
########
