########
###  ###
### $@##
###.$$ #
### .  #
# $ *$##
#  .. ##
##  . ##
########
