#########
#   . ###
# $$$ ###
##@#  ###
##**$.###
##  . ###
## #  ###
##  .####
#########
