#########
### . ###
### . ###
#  * $###
# *+* ###
## #$  ##
##  $  ##
#####  ##
#########
