#########
## . . ##
## .$  ##
## * ####
##$$ ####
#@  $####
# #$ ####
#..  ####
#########
