########
### @###
###$ ###
### $###
### * ##
## .. ##
##$.$. #
#   *  #
#   ####
########
