########
#  #####
#. #####
#      #
#.$.*$ #
# $   ##
## .####
##$$####
##+ ####
########
