#########
#  ######
#  ######
# . #####
#. $  ###
#$* # ###
#@* *$ ##
## .   ##
#########
