########
##  ####
##    ##
##*. $ #
# *.$. #
#  . ###
### $###
###$ ###
###@ ###
########
