########
##+  ###
##$#$###
##     #
# .#$  #
#   *.##
##    ##
########
