#########
## .#####
## @  ###
## $*$###
## # .###
##$. * ##
#  *   ##
#   #####
#########
