#########
# .  ####
#  *$####
# * $ ###
# .  .###
#  #  ###
##$#$####
##.@ ####
#########
