########
###  ###
### $###
###. ###
###  ###
## *   #
#  $.$ #
# @**###
# .  ###
########
