########
##  ####
##. . ##
##  .$##
###$*@##
## .$$ #
#  $   #
# . ####
########
