########
#+  ####
#.#$   #
#.. #  #
#  $$ ##
## $  ##
####  ##
########
