########
###  ###
###. ###
##@* ###
##$* ###
## .$  #
# . $  #
# $. ###
###  ###
########
