########
#  #####
# .. $ #
# $$$$@#
## . ###
## . ###
## . ###
###.$###
###  ###
########
