########
###  ###
###  ###
###  ###
###$ ###
#@ $*. #
# * .* #
### $ .#
####   #
########
