########
## @####
##$ ####
## $####
##.$   #
# .$*..#
#  $   #
### .###
###  ###
########
