########
### .###
### $###
# $  ###
# ..$###
# *.$.@#
##   $ #
###  ###
###  ###
########
