########
#@ #####
# $#####
#*   ###
# .  ###
# .**$ #
## $   #
###. ###
###  ###
########
