########
###  ###
#    ###
# #.$ ##
# $ #.##
## *@$ #
##   . #
########
