########
##  ####
#  .$  #
#  * . #
# . * ##
###.$$##
### $@##
###  ###
########
