########
## @####
##$ ####
# .$####
#*   ###
# .$*  #
# .*   #
###  ###
###  ###
########
