########
###  ###
###$@###
###.$###
### * ##
###   ##
### ** #
#    . #
#  *  ##
########
