#######
# @####
#*$ ###
# * $ #
# $.$.#
# .   #
# .*  #
##  ###
#######
