#######
### @ #
###$.$#
### * #
#   $ #
#.* . #
#$.$ .#
#   ###
#######
