#########
###  ####
##   $@##
## . # ##
#  *#* ##
# .  * ##
## $#$###
##   .###
#########
