#########
#. @#####
#$$$#####
# .$. ###
# * . ###
#. #  ###
# $$ ####
# .  ####
#########
