#########
##  #####
## .#####
#   $ ###
# . ..###
# $ $ ###
# *$#*###
# . $@###
#########
