#########
###  ####
###   ###
### $*###
### $.###
#@ $..  #
# .$.$$ #
### .  ##
#########
