#########
###  ####
###  ####
###$  ###
###  $  #
##  *.. #
# *$*. ##
#@$.  ###
#########
