#########
### . ###
### .$###
### * ###
##    ###
##.**$  #
# $$    #
# .@#####
#########
