#########
###  ####
###   ###
## *  ###
# . .$  #
# $.$.  #
###$*$###
### + ###
#########
