########
#   ####
#  $@###
## *$###
## *.###
## $.  #
## *$  #
## . ###
## . ###
########
