#########
###@. ###
###$* ###
### * ###
### .$###
#   $*  #
#   .*  #
###   ###
#########
