#########
### . ###
###@*$###
#  $  ###
#  $.$###
### * ###
### .$  #
### . . #
#########
