########
## + ###
##$.$###
## * ###
## * ###
## * ###
## * ###
#  *   #
#  * . #
##  $ ##
###  ###
########
