########
##@ ####
##$* ###
#  * ###
# .*. ##
## * $##
##     #
####   #
########
