########
###@  ##
###$# ##
##    ##
## # .##
##.$*  #
####   #
########
