########
###  ###
#. .* ##
# # * ##
#   $  #
### $$.#
###@  ##
########
