########
### $.##
#. .* ##
# # * ##
#   $  #
### $$.#
### @ ##
########
