########
#... ###
#+ #$$ #
#$     #
#   #  #
###$# ##
###   ##
########
