########
##  . ##
## $# ##
#  .#  #
#   .  #
##$#$$ #
##+  ###
########
