########
# . ####
#  $   #
##.. . #
#@$$# ##
# $   ##
###  ###
########
