########
####  .#
##@$.# #
##$#   #
#  $   #
#   $#.#
####  .#
########
