########
##  ####
## .$@##
## *#$##
## * * #
#    # #
#   .  #
########
