########
###@ ###
### .  #
###$ $ #
#   # ##
# .$*  #
##  .  #
########
