########
# . ####
#      #
##.$$  #
# . # ##
#  $#$##
### @.##
########
