########
##   @##
##*#$$##
# $   ##
#  *# ##
#.  .  #
####  .#
########
