########
### . ##
### . ##
#.$$.  #
# # $$.#
# # $@##
#    ###
########
