########
#####@ #
#####$$#
###  $ #
## ..  #
##   # #
####  .#
########
