########
# @ ####
#  $   #
##  #*.#
## $ $.#
###  * #
### . ##
########
