########
####  ##
##.* $##
##@    #
# . #$ #
#  *  *#
####   #
########
