########
####  ##
####$ ##
#      #
# .#   #
##$$$. #
##+* . #
########
