########
###  ###
#..$  ##
#..$ $##
#+# $  #
#  $   #
##  ####
########
