########
#####  #
## $@$ #
# ..#  #
# ..$ .#
## $$  #
####  ##
########
