########
#   ####
# #$####
#@$ $  #
##* ...#
#   $  #
#  .####
########
