########
# @ ####
# $$.. #
## $  $#
## #* .#
## .   #
##  ####
########
