<><><><><><><><><><><><><><><>
<> _<><><><><><><><><><><><><>
<>                <><><><><><>
<>    <><><><>B   <><><><><><>
<><><><><><><>    <><><><><><>
<><><><><><><>P <><><><><><><>
<><><><><><><><><><><><><><><>
