<><><><><><><><><><><><>
<><><> _<><><><><><><><>
<><><> _<><><><><><><><>
<><><>  <><><><><><><><>
<><><>  <><><><><><><><>
<><><>  <><><><><><><><>
<><><>              <><>
<><><>  <><><><>    <><>
<><><>  <><><><>  <><><>
<><><>B <><><><>B <><><>
<><><>          P <><><>
<><><><><><><><><><><><>
