<><><><><><><><><><><>
<>                  <>
<>                  <>
<>     _   _   _    <>
<>        B         <>
<>        B         <>
<>        B         <>
<>                  <>
<>        P         <>
<>                  <>
<><><><><><><><><><><>
