
<><><><><><><><><><><>
<><><>PR<><><><><><><>
<><><>    B         <>
<><>    <>  <><>    <>
<>    <><>    <>  <><>
<>  B     B     B   <>
<>    <>    <><>    <>
<><>  <><>  <><>  <><>
<>  B <>  B       <><>
<>          <>    <><>
<>    <>    <><><><><>
<><><><><><><><><><><>
