#### ####
#  ###  #
#  $ $  #
# $#.## #
##  .   ##
 # .@.#$ #
 ## #    #
  #   ####
  #####
