 #####
##   ###
# . . .#
# # ## ##
#    $$@#
### # $ #
  #   ###
  #####
