    #####
   ##   ##
  ## .#  #
 ##   @  #
##    #  #
#  $ #####
# * ##
#  ##
####
