####
#  ####
#     #
#     #
### ###
# $$$ ##
# ...@ #
####   #
   #####
