      ####
#######  #
#        #
#  $ #.# #
# $$## # ##
### . @   #
  ###  #  #
    ##.  ##
     #####
