     ####
   ###  #
 ### .. #
 # $$#  #
## # #@##
#  *    #
#   #   #
######  #
     ####
