#####
#   ##
# #  ##
#. #$ #
#  @  #
#.##$##
#    #
######
