 #######
 #  #  ##
## **$. #
#   #   #
#   @ ###
#  ####
####
