  ####
 ##  #
##   ##
#  *$ #
# # #@#
#  *. #
###  ##
  #  #
  ####
