  #####
###   #
#     #
#  #.###
##@$$$ #
 #.#.# #
 #     #
 #  ####
 ####
