####  ####
#  ####  #
#        #
#  ####  #
##@##. $##
#  #.$* #
#      ##
#  #  ##
#######
