 #######
##  #  ##
# .$*$. #
#   #   #
##  *  ##
 #@ *  #
 #######
