 ####
 #  #
 #. ##
 #$@ #
## * #
#  * #
#  * #
## * #
 #  ##
 ####
