  #####
  #+ .###
  #     #
  ## $  #
 ###$####
## $   #
#  . * #
#   #  #
########
