#####
#   #####
# #   $ ##
#.$.$..@ #
#### #$  #
   #   ###
   #####
