   ####
 ### @##
##   * ##
#  ##*  #
#    *  #
##  #$# #
 #   .  #
 #  #####
 ####
