##### ####
#   # #  #
#  $###@ #
## $  $  #
 # ....$ #
 ##  #  ##
  #######
