 #######
 #  #  ###
 #$   $  #
 # .#**  #
## #@ # ##
#  ..#. #
# $   $ #
######  #
     ####
