 ####
 # @##
## . ###
# $$$. #
#..$.# #
# $ $  #
## .  ##
 ######
