 #######
 #     #
 # .$. #
##$. $##
#  *  #
# $.$##
##@. #
 #####
