 #####
 #   ##
##* ..##
#   #  #
# *    #
# * # ##
##  $$#
 ### @#
   ####
