#####
#   ###
#     #
## #. ###
#@***$* #
#       #
#  #  ###
#######
