  ####
 ##  ###
## ..  #
#  *   #
# $$ ###
## *.#
 # $ #
 # * #
 # @##
 ####
