  #####
  #   #
### . ##
#  *$* ##
# # * * #
#    * @#
###  ####
  ####
