   #####
 ###   #
##     #
# *** ##
#  *@ #
# .*$##
##   #
 ##  #
  ####
