  ####
###  #
# .* ##
# #   #
#@**  #
# #   #
# $* ##
###  #
  ####
