          ####
          #  #          ####
      #####  #          #  #         ####
      #   #  #      #####  #         #  #
      #     ####    #   #  #     #####  #
      ####     #    #     ####   #   #  #
         # #   #   #####     #   #     ####
         # #####   #   # #   #  #####     #
     ##### ##  #####     #####  #   # #   #
     #   # ##  #  #####     #####     #####
     #     ##  #  #  ## #   #  #####     ####
     ####     ##  #  ## #####  #  ## #   #  #
       #  ##     ##  ## #####  #  ## #####  #
       #  #  ##     ###       ##  ## #####  #
       #  #  #  ##       ###     ###       ####
       ####  #  #  ##### ##  ##       ###     #
         #####  #  ##### ##  #  ##### ##  #   #
         #  #####  #   # ##  #  ##### ##  #####
     #####  #  #####     #####  #   # ##  #
     #   #  #  #  #####     #####     #####
    ##     #####  #   # #   #  #####     #
    #####     #####     #####  #  #  #   #
    #  ## #   #  #####     #####  #  #####
#####  ## #####  #  ## #   #  #####  #
#   #  ## #####  #  ## #####  #  #####
#     ###       ##  ## #####  #  #  ####
####       ###     ###       ##  #  #  #
  #  ##### ##  ##       ###     ##  #  #
  #  ##### ##  #  ##### ##  ##     ##  #
  #  #   # ##  #  ##### ##  #  ##     ####
  ####     #####  #   # ##  #  #  ##     #
    #####     #####     #####  #  ## #   #
    #   # #   #  #####     #####  ## #####
    #     #####  #   # #   #   ##### #
    ####     #   #     #####   #   # #
      #  #   #   ####     #    #     ####
      #  #####     # $#   #    ####     #
      #  #         # .#####      #  #   #
      ####         # @#          #  #####
                   ####          #  #
                                 ####
