   ####
####  ##
# $    ##
#.+***  #
# $     #
#####  ##
    ####
