  #######
###     #
#   ### #
# #$* # #
#  $. # #
###$.   #
  #@. ###
  #####
