 ####
 #  ###
## * @#
#  *#$##
#  .   #
## * # #
 # * # #
 ## #  #
 #    ##
 #   ##
 #####
