 ####
 #  ######
 #       #
## ####  #
#@* ### ##
#  * ## #
##  * # ##
 ## .$#  #
  ##     #
   ####  #
      ####
