   ####
####@ ###
#  $ $  ##
# #$#$#  #
# # . .  #
# # . . ##
# ## ####
#    #
######
