 #####
 #   ####
 # #$$  #
## #@ # #
#  #$. .#
#  .$. ##
###  # ##
  ##    #
   ##   #
    #####
