      ####
#######  ##
#@$       #
# *###  # #
##..    # #
##*#      #
# $  ######
#   ##
#####
