 ########
 #  ##  #
 #.$   .###
 # .## $  #
##$### #  #
# $    # ##
# @ #.    #
#######   #
      #####
