  #####
  #   ###
  # #*  #
 ##+*   #
 #   # ##
##$#*#  #
#    *  #
#   ##  #
#########
